GAAAAAAAAAAAAAAGGGGGGGGGGGGGGGGGGGGGGGGGGG
GAPPPPPPPPPPPPAGAAAAAAAAAAAAAAAAAAAAAAAAAA
GAEEEEEEEEEEEPAGAPPPPPPPPGGGGGGGGEEEAEEPPG
GAEEEEEPPPPPEPAAAPEEEEEEPGGGGGGGPEEEAEEPPG
GAEPPPPPPEEEEPPPPPPPPPPEPGGGPPPPPEAAAAEPPG
GAEEEEEEPGGGGGGGGGEPPPPEPGGGGGGGPEEEEEEPPG
GAAAAAAAGGGGGGGGGGEEEEEEPPPPPPPPPPPPPPPPPG
GGGGGGGAGGGGGGGAAAATTTTTTTTTTTTTTTTTTTTTTG
GEEEEEEAEEEEEEEAEGGGGGGGGGEEEEGGGGGGGGGGGG
GEAAAEEAAAEAAAEAEGGTTTTGGGEEEEGGGPPPPPPPPG
GEAEAEEAEAEAEAEAEGGTGGTPPPGGGGPPPPGGGGGGPG
GEAEAEEAEAEAEAEAEGGTGGTGTTTGGTTTGPGGGGGGPG
GEAEAEEAEAEAEAEAEGGTGGTGGPPPPPPGGPGGGGGGPG
GEAEAEEAEAEAEAEAEGPTGGTGAAAAAAAAAPPPPPPGPG
GEAEAAAAEAAAEAAAEGPTTTTGAGGGGGGGGPGGGGGGPG
GEAEEEEEEEEEEEEEEGPGGGGGAGGGGGGGGPGGGGGGPG
GGAGGGGGGGGGGGGGGGPPPPPGAGGGGGGGGPGGGGGGPG
GGAGGGGGGGGGGGGGGGGGGGGGAGGGGGGGGPPPPPPPPG
AAAAAAAAAAAAAAAAAAAAAAAAAAAAAAAAAAGGGGGGGG
TTTTTTTTTTTTTAGGGGGGGGGGGGGGGGGGGGGGGGGGGG
TTTTTTTTTTTTTAEEGGEEGEEGGEEGGGTTTTTTTTTTTT
TTTTTTTTTTTTTAEEGGEEPEEGGEEGGGTPPPPPPPPPPT
TTTTGGGGGTTTTAEEGGEEPEEGGEEGGGTPTTTTTTTTPT
TTTTGGGGGTTTTAEEGGEEPEEGGEEGGGTPTPPPPPPTPT
TTTTGGGGGTTTTAPPPPPPXPPPPPPGGGTPTPEEEEPTPT
TTTTGGGGGTTTTAEEGGEEPEEGGEEGGGTPTPEEEETTPT
TTTTTTTTTTTTTAEEGGEEPEEGGEEGGGTPTPPPPPPPPT
TTTTTTTTTTTTTAEEGGEEPEEGGEEGGGTPTTTTTTTTTT
TTTTTTTTTTTTTAEEGGEEGEEGGEEGGGGGGGGGGGGGGG
AAAAAAAAAAAAAAAAAAAAAAAAAAAAAAAAAAAAAAAAAA
GGGGGPPPPPGGGPGGGPGGGPGGGGGGGGGGGGGGGEEEGG
GEEEGPGGGPGGGPGGGPGGGPGTTTTTTTTTTGGGGEEEGG
GEEEGPGPGPGPGPGPGPGPGPGGGGGEEEEEEGGGGEEEGG
GEEEGPGGGPGPGPGPGPGPGPGGGGGTTTTTTTTTTTTTTT
GGGGGPPPPPGPGGGPGGGPGGGGGGGGGGGGGGGGGGGGGG
GEEEGGGGGGGPGGGPGGGPGGGGGGPPPPPPPPPPPGGGGG
GEEEGTTTTGEEEEEEEEEEEEEEGGPEEGGGGGGGPGGGGG
GEEEGTTTTGEAAAAAAAAEEEEEGGPEEGGEEEEEPGAAAA
GGGGGPPPPGEAEEEEEEAAAAAEGGPEEGGEEEEEPGPPPP
GEEEGTTTTGEAAAEAAAAEEEEEGGPEEGGEEEEEPGEEEE
GEEEGTTTTGEEEAEEEEEEEEEEGGPEEGGGGGGGPGAAAA
GEEEGGGGGGGGGAGGGGGGGGGGGGPPPPPPPPPPPGGGGT