G A A A A A A A A A A A A A A G G G G G G G G G G G G G G G G G G G G G G G G G G G
G A P P P P P P P P P P P P A G A A A A A A A A A A A A A A A A A A A A A A A A A A
G A E E E E E E E E E E E P A G A P P P P P P P P G G G G G G G G E E E A E E P P G
G A E E E E E P P P P P E P A A A P E E E E E E P G G G G G G G P E E E A E E P P G
G A E P P P P P P E E E E P P P P P P P P P P E P G G G P P P P P E A A A A E P P G
G A E E E E E E P G G G G G G G G G E P P P P E P G G G G G G G P E E E E E E P P G
G A A A A A A A G G G G G G G G G G E E E E E E P P P P P P P P P P P P P P P P P G
G G G G G G G A G G G G G G G A A A A T T T T T T T T T T T T T T T T T T T T T T G
G E E E E E E A E E E E E E E A E G G G G G G G G G E E E E G G G G G G G G G G G G
G E A A A E E A A A E A A A E A E G G T T T T G G G E E E E G G G P P P P P P P P G
G E A E A E E A E A E A E A E A E G G T G G T P P P G G G G P P P P G G G G G G P G
G E A E A E E A E A E A E A E A E G G T G G T G T T T G G T T T G P G G G G G G P G
G E A E A E E A E A E A E A E A E G G T G G T G G P P P P P P G G P G G G G G G P G
G E A E A E E A E A E A E A E A E G P T G G T G A A A A A A A A A P P P P P P G P G
G E A E A A A A E A A A E A A A E G P T T T T G A G G G G G G G G P G G G G G G P G
G E A E E E E E E E E E E E E E E G P G G G G G A G G G G G G G G P G G G G G G P G
G G A G G G G G G G G G G G G G G G P P P P P G A G G G G G G G G P G G G G G G P G
G G A G G G G G G G G G G G G G G G G G G G G G A G G G G G G G G P P P P P P P P G
A A A A A A A A A A A A A A A A A A A A A A A A A A A A A A A A A A G G G G G G G G
T T T T T T T T T T T T T A G G G G G G G G G G G G G G G G G G G G G G G G G G G G
T T T T T T T T T T T T T A E E G G E E G E E G G E E G G G T T T T T T T T T T T T
T T T T T T T T T T T T T A E E G G E E P E E G G E E G G G T P P P P P P P P P P T
T T T T G G G G G T T T T A E E G G E E P E E G G E E G G G T P T T T T T T T T P T
T T T T G G G G G T T T T A E E G G E E P E E G G E E G G G T P T P P P P P P T P T
T T T T G G G G G T T T T A P P P P P P X P P P P P P G G G T P T P E E E E P T P T
T T T T G G G G G T T T T A E E G G E E P E E G G E E G G G T P T P E E E E T T P T
T T T T T T T T T T T T T A E E G G E E P E E G G E E G G G T P T P P P P P P P P T
T T T T T T T T T T T T T A E E G G E E P E E G G E E G G G T P T T T T T T T T T T
T T T T T T T T T T T T T A E E G G E E G E E G G E E G G G G G G G G G G G G G G G
A A A A A A A A A A A A A A A A A A A A A A A A A A A A A A A A A A A A A A A A A A
G G G G G P P P P P G G G P G G G P G G G P G G G G G G G G G G G G G G G E E E G G
G E E E G P G G G P G G G P G G G P G G G P G T T T T T T T T T T G G G G E E E G G
G E E E G P G P G P G P G P G P G P G P G P G G G G G E E E E E E G G G G E E E G G
G E E E G P G G G P G P G P G P G P G P G P G G G G G T T T T T T T T T T T T T T T
G G G G G P P P P P G P G G G P G G G P G G G G G G G G G G G G G G G G G G G G G G
G E E E G G G G G G G P G G G P G G G P G G G G G G P P P P P P P P P P P G G G G G
G E E E G T T T T G E E E E E E E E E E E E E E G G P E E G G G G G G  P G G G G G
G E E E G T T T T G E A A A A A A A A E E E E E G G P E E G G E E E E E P G A A A A
G G G G G P P P P G E A E E E E E E A A A A A E G G P E E G G E E E E E P G P P P P
G E E E G T T T T G E A A A E A A A A E E E E E G G P E E G G E E E E E P G E E E E
G E E E G T T T T G E E E A E E E E E E E E E E G G P E E G G G G G G G P G A A A A
G E E E G G G G G G G G G A G G G G G G G G G G G G P P P P P P P P P P P G G G G T